2222222-
0000000-
1111111-
0000001-
0222201-
0222201-
0222201-
0222201-
0000001-
1111111-
0000000